él es su único hijo .	es solo niño .
toma algo .	algunos <unk> .
<unk> la luz .	cierra la luz .
sus zapatos están <unk> .	tus <unk> son <unk> .
le tiene miedo a los gatos .	él tiene miedo de los gatos .
me <unk> allí un par de días .	voy a <unk> una días para ir allí .
<unk> a menudo pensaba en el futuro .	los <unk> <unk> <unk> <unk> <unk> a menudo de la <unk> .
me gusta esa universidad , pero está demasiado cerca de casa .	es demasiado vieja para mi casa , pero es demasiado .
todos <unk> <unk> .	todo el mundo se ve <unk> .
aquella chica se parece a maría .	mary parece a la chica que se ve .
al final del discurso , ella <unk> la palabra .	ella <unk> al final de la palabra a la palabra .
se <unk> por la <unk> de su amigo .	ellos <unk> su amigo de <unk> .
tom está <unk> lo que dijo .	tom dijo lo que dijo .
solía haber un puente aquí .	solía ser una copa aquí .
no hemos sabido de ella desde entonces .	no tenemos que su hijo desde entonces .
no me acuerdo dónde puse mi llave .	no recuerdo mis llaves .
ya no deseo <unk> parte de este proyecto .	no ojalá ser un estudiante de este proyecto .
pienso que esto es realmente <unk> .	creo que esto es realmente joven .
los doctores llevaban <unk> <unk> en la nariz y la boca .	las <unk> y sus <unk> <unk> <unk> <unk> <unk> <unk> <unk> <unk> <unk> <unk> <unk> <unk> las respuestas .
tom echó algo de leche en el vaso y se lo <unk> a mary .	tom y mary se <unk> en el vaso de <unk> a la leche .
él se <unk> de ella después de años de <unk> .	él <unk> de su <unk> <unk> <unk> <unk> <unk> .
llame usted a un guardia .	<unk> un <unk> .
no te voy a dar mi número de teléfono .	no voy a <unk> mi número de teléfono .
solo continúa .	deja de <unk> .
probablemente es la enfermedad que <unk> <unk> .	es <unk> que <unk> las <unk> de las <unk> .
tom aún no puede sacar a mary de su cabeza .	tom todavía no puede <unk> de su <unk> de mary .
esta <unk> es para el té .	este té es <unk> .
¿tienes <unk> de <unk> ?	¿tienes un <unk> de <unk> ?
ya veo que esto se te da bien .	puedo ver esto a <unk> .
comí tres <unk> de torta .	comí tres <unk> de tres años .
ella se fue con él al <unk> .	ella lo fue al zoo .
le <unk> <unk> <unk> .	gracias demasiado <unk> en <unk> .
ellos me <unk> a <unk> .	ellos me <unk> solo a mí .
este lugar me da <unk> .	este <unk> me <unk> el lugar .
hago <unk> dos horas por día .	me <unk> por dos horas todos los días .
puede que no sea suficiente .	esto no podría ser lo suficientemente <unk> .
bajo ninguna <unk> debes <unk> la habitación .	no tienes que <unk> la habitación .
prefiero la <unk> a la <unk> .	prefiero <unk> a <unk> .
¿sabes dónde será la reunión de mañana ?	¿dónde está decidido para hacer mañana ?
no fue sino hasta que me <unk> del colegio que me di cuenta de la importancia de estudiar .	fue el colegio que no lo <unk> de la escuela .
en seguida <unk> a <unk> el proyecto .	ellos <unk> el plan .
¿por qué no tengo novio ?	¿por qué no tengo un novio ?
tu inglés es perfecto .	su <unk> es <unk> inglés .
¿cómo estuvo su cumpleaños ?	¿cómo estuvo tu cumpleaños ?
no crees esa historia , ¿o si ?	<unk> no <unk> eso , ¿no ?
pensé que tom estaba de vacaciones .	pensé que tom estaba en contacto .
será mejor que te vayas ya a la cama .	ahora me había <unk> mejor que la cama .
es la voz de una vieja .	es una gran voz de una anciana .
la misión fue un <unk> .	el <unk> estaba <unk> .
te amo tal como sos .	solo estás como te amo .
no me importa , con tal de que seas feliz .	no me <unk> feliz como tú .
todavía estás <unk> ¿verdad ?	todavía no estás ocupado , ¿verdad ?
no olvides que tenemos deberes .	no tenemos ese tarea .
no <unk> el sentido de todo esto .	no me <unk> de todo este campo .
¿tom está herido ?	¿tom es <unk> ?
<unk> como un <unk> ?	¿te gusta un <unk> ?
soy <unk> .	estoy <unk> .
creía que tom era canadiense .	pensé que tom era canadiense .
ella se <unk> en su trabajo .	ella le <unk> a su trabajo en su trabajo .
mira quien está despierto .	¿quién es <unk> .
¿dónde nos <unk> el autobús ?	¿dónde nos <unk> el autobús ?
vi a alguien .	lo vi .
este trabajo es lo suficientemente simple para que lo haga un niño .	este es lo suficientemente tonto para hacer un niño para hacer .
quiero que tú vayas .	quiero que vayas .
los zapatos están <unk> .	los zapatos son <unk> .
<unk> a hacer esto hace cuatro años .	parece que <unk> hace años .
¿cómo de profundo es el lago ?	¿cómo se siente el lago ?
<unk> .	<unk> .
no sé de ella desde entonces .	no he oído de ella desde que ella .
yo comprendo tu lengua .	entiendo tu <unk> .
eres incapaz de hacer eso .	es imposible que hacerlo por hacer .
¿alguien le conoce ?	¿alguien lo conoce ?
está realmente enfadado .	él es realmente <unk> .
necesito <unk> todo lo que pueda .	necesito todo el <unk> .
¿alguna vez te has <unk> en una <unk> de <unk> ?	¿has <unk> alguna <unk> en un <unk> ?
este libro merece atención .	este libro es el libro de los <unk> .
haría cualquier cosa por ustedes .	haría cualquier cosa por ti .
yo los podría matar .	podría <unk> .
todavía tenemos que encontrar a tomás .	todavía tenemos que encontrar a tom .
lo <unk> en falta .	lo <unk> .
ella pocas veces sale .	ella <unk> al béisbol .
<unk> si no vas a llegar a tiempo .	no sé si no te <unk> aquí .
<unk> encontrar el libro ?	<unk> encontrar el libro ?
ha pasado más de un año desde que tom <unk> boston .	el año pasado de tom ha estado en boston .
¿quién no estaba aquí ?	¿quién estaba aquí ?
la noche aún es joven .	la noche está todavía .
en la oficina ha habido mucha <unk> esta mañana .	hay un <unk> de la oficina de la oficina de <unk> .
tengo un libro en la mano .	tengo un libro en mi libro .
tom no podía decidir cuándo comenzar .	tom no pudo hacer cuando quiera .
me pregunto si tom me <unk> francés .	me pregunto si tom me <unk> francés .
no tengo nada que ver con sus problemas .	no tengo que hacer nada con sus <unk> .
le veré en boston .	te veré a ver a boston .
tom le pasó a mary el <unk> .	tom <unk> la carta a mary .
no tuvimos nada de ayuda de tom .	no vimos a tom de ayuda .
tenemos cinco dedos en cada mano .	tenemos cinco personas <unk> .
ya he <unk> tu número de teléfono .	ya he <unk> tu número .
se <unk> al ver el <unk> .	ellos estaban el <unk> de los estados unidos .
está muy <unk> .	es muy <unk> .
yo estaba escribiendo una carta cuando él llegó .	yo estaba enfermo cuando tenía una carta cuando tenía una carta .
se va al extranjero dentro de <unk> meses .	ella está en meses .
hay un control <unk> <unk> del sofá .	hay un gran terremoto bajo la tele .
el diez de julio , el <unk> fue <unk> .	el <unk> se <unk> , estaba en <unk> .
podemos ir .	podemos ir .
todos aman a los <unk> .	a todos los <unk> les gusta el mundo .
sea cual sea tu <unk> y lo feliz que seas en ella , habrá <unk> en los que <unk> haber <unk> otra carrera .	no puedes <unk> qué <unk> qué <unk> tu <unk> , puedes <unk> <unk> <unk> <unk> <unk> <unk> en <unk> <unk> <unk> <unk> .
vuestra hija ya no es una niña .	tu hija es una <unk> no es una <unk> .
eso no es asunto nuestro .	no es nuestra <unk> de nuestra maleta .
está deprimido .	está deprimido de él .
tom trató de <unk> a mary a jugar <unk> .	tom trató de <unk> a mary .
estoy <unk> .	estoy <unk> .
dos ladrones entraron en una tienda .	<unk> una tienda <unk> .
ella se casó con un <unk> .	ella se casó con un casado .
este es un buen sushi .	este es bueno .
tengo que resolver muchos problemas .	tengo que comprar mucho el problemas .
cierra la puerta .	la puerta se quedó cerrada .
el clima es <unk> y <unk> .	el <unk> es <unk> y <unk> .
ella siempre está ocupada .	ella siempre está ocupada .
tengo que <unk> un regalo que te va a <unk> .	tengo que <unk> un <unk> .
te veré el mes que viene .	te veré el próximo mes .
esa es una pregunta muy difícil .	esa pregunta es una pregunta .
me sentí bastante <unk> .	sentí de <unk> .
¿es importante ?	<unk> importante ?
¿le gusta san <unk> ?	¿te gusta <unk> ?
tom va a poder venir a nuestra fiesta mañana .	tom es capaz de fiesta mañana a nuestra fiesta mañana .
tom siempre parece estar <unk> en algo .	tom siempre se parece estar <unk> algo .
esta es una <unk> <unk> . no cuesta nada .	esto no es <unk> que <unk> .
ellos <unk> dinero de él .	ellos lo <unk> de dinero .
no te culpo por el accidente . no fue culpa tuya .	no te lo di a tu culpa .
los <unk> <unk> todo el tiempo .	todos <unk> del trabajo <unk> .
estoy <unk> a ello ahora .	lo estoy <unk> a ahora .
hay a <unk> les gusta el béisbol , y a <unk> les gusta el fútbol .	a algunos estudiantes les gusta la gente les gusta la gente les gusta el béisbol .
quisiera pasar algunos días con tom .	quisiera encontrar un días con tom .
<unk> enseguida .	<unk> que es bastante bien .
ella me <unk> al <unk> .	ella me <unk> a la <unk> .
¿qué hay que hacer ?	¿qué está ahí ?
tom ha estado trabajando en este informe desde esta mañana .	este medicamento ha estado en el béisbol de tom desde el béisbol .
ella se <unk> en cantante .	ella se hizo un niño .
él no lo volvió a decir .	él dijo que nunca había ido .
¿qué te hizo cambiar de idea ?	¿qué te ves las mañanas ?
tom no tenía idea de por qué mary se fue temprano .	tom no tuvo idea de qué había comido temprano .
una <unk> de <unk> <unk> al <unk> .	<unk> una <unk> de <unk> <unk> <unk> <unk> .
tom se cree <unk> .	él piensa que tom está <unk> .
yo <unk> un <unk> en mi jardín .	me <unk> un árbol en mi jardín .
tom no tiene un <unk> <unk> .	tom no tiene un <unk> .
tom quería a mary .	tom quería mary .
<unk> que tenés suerte ?	¿no crees que tú no te <unk> .
¿con qué les <unk> ?	¿qué hiciste con el <unk> ?
<unk> él llegará tarde a la escuela .	él es difícil de estar tarde para la escuela .
tráeme una toalla <unk> .	<unk> un gato .
es su <unk> .	eso es su <unk> .
quiero que se <unk> aquí .	quiero que tomes aquí .
no vino nadie .	nadie vino .
por extraño que <unk> , ella de repente <unk> .	le <unk> a <unk> a ella , ella le gusta decir .
ellos empezaron a <unk> .	ellos van a llorar .
a cada uno de nosotros se nos dio <unk> dólares .	<unk> un montón de tres veces a las dos días .
deberíamos haberle contado la verdad .	debería haber hecho lo que deberíamos .
me acuerdo de <unk> visto el año pasado .	espero que te <unk> el año pasado .
lo que se habla es más importante que cómo se habla .	lo que es más importante acerca de lo que dices .
tom fue a la playa la semana pasada .	tom fue al cine la semana .
<unk> cinco minutos más .	<unk> cinco minutos minutos .
nunca he <unk> en avión .	nunca he <unk> un <unk> .
la madre <unk> <unk> esa ayuda <unk> para ayudar a la gente pobre de la india y de todo el mundo .	su madre y el mundo <unk> <unk> <unk> a su madre .
¿has <unk> en una prueba alguna vez ?	¿has visto un examen de primera vez ?
¿de quién es este vino ?	¿esto es el vino <unk> ?
sabía que <unk> a tom .	le gustaría que tom a encontrar .
<unk> la pregunta .	<unk> la pregunta .
no pensé que era tan malo .	no creo que era tan malo .
¿por qué estás tan seguro ?	¿por qué estás tan seguro ?
¿qué te dio tom en tu cumpleaños ?	¿qué te <unk> tom a tu cumpleaños ?
¿puede alguno de éstos ser real ?	¿puede ser verdad ?
cogió un taxi para ir al hospital .	ella tomó el hospital .
debería ir a casa y dormir un poco .	debería haber dormir a casa y a casa .
el piloto <unk> el avión sin problemas .	el avión se <unk> el avión .
el dinero es la <unk> de todos los <unk> .	todo el dinero de la <unk> es el <unk> .
ayer cogí el <unk> .	ayer me <unk> ayer .
¿en qué idioma se habla en los estados unidos ?	¿qué lengua se habla en los estados unidos de américa ?
deberíamos hacerlo todos los lunes .	deberíamos hacer esta lunes .
<unk> sentí un <unk> dolor en mi estómago .	de repente me <unk> un segundo , mi hijo lo <unk> un segundo .
le aconsejó que <unk> el dinero .	ella le <unk> el dinero .
debo <unk> tu promesa .	te debo <unk> de tu <unk> .
eres una mujer .	eres una mujer .
tengo que <unk> un coche .	tengo que <unk> un coche .
¿por qué siempre <unk> tarde al colegio ?	¿por qué siempre te <unk> esa escuela para la escuela ?
<unk> tom a beber a menudo con mary ?	<unk> a tom a mary con john ?
ya había más de veinte personas <unk> allí .	había <unk> ahí dentro ahí .
¿no te gustaría tomar otro vaso de leche ?	¿no tienes un vaso de leche de leche ?
<unk> todos ellos estén <unk> ahora .	todos los <unk> están muerto .
¿qué es lo que verdaderamente te encanta hacer ?	¿qué te ha dicho lo que te diga ?
ella fue <unk> por su abuelo .	ella estaba <unk> por su abuelo .
el niño está <unk> .	el niño es <unk> a la <unk> .
acabé <unk> disculpas .	<unk> lo <unk> .
puede que su historia sea cierta .	puede ser verdad .
tom fue <unk> .	tom estaba <unk> .
él estaba profundamente dormido .	él estaba completamente <unk> .
un estudiante de <unk> media hizo este <unk> .	este <unk> <unk> un estudiante de colegio .
iré siempre y cuando los demás <unk> .	voy a ir a ir a ir a la <unk> .
no tenemos un perro .	no tenemos un perro .
ella se quedó dormida con el <unk> puesto .	ella se quedó con ella .
me gusta el <unk> corto .	me gusta el pelo .
fue <unk> ver lo rápido que <unk> el niño .	<unk> la caja era niño .
esta es una <unk> <unk> .	esto es un <unk> .
después de comer , siempre me da sueño .	después de terminar el <unk> , pero siempre se me <unk> después de mí .
<unk> a la chica a su casa .	me <unk> su casa .
tendrás que pagar .	tienes que <unk> .
¿crees que tom <unk> hacer eso ?	<unk> pensar que tom <unk> hacer eso ?
no os esperaba tan pronto .	no esperaba pronto tan pronto .
¿cuál es tu <unk> favorito de <unk> ?	¿quién es tu <unk> de <unk> ?
¿cuál es la <unk> del cámara de allí ?	¿qué hay de <unk> de <unk> ?
john fue a la tienda .	a la tienda se fue a john .
tomé de la mano a mi <unk> cuando <unk> la calle .	me <unk> cuando <unk> la mano cuando <unk> en el nombre .
su casa es grande .	tu casa es grande .
<unk> un <unk> .	te gusta un millón de <unk> .
tom y mary <unk> a john .	tom y mary son <unk> de john .
hablando <unk> , él no es de <unk> .	<unk> , <unk> está hablando .
me <unk> cuando sonó el teléfono .	yo ¿cuándo <unk> la teléfono .
no creo que eso sea posible .	no creo que eso es posible .
tengo algo de <unk> de <unk> para la <unk> .	tuve un <unk> para un <unk> <unk> por <unk> .
sé cómo resolver el problema .	sé cómo se <unk> el problema .
esta manzana sabe <unk> .	este <unk> <unk> a los <unk> <unk> <unk> .
tenemos algo en común .	yo tienes algo en común .
¿le ha dicho a usted algo <unk> ?	<unk> que te ha <unk> ?
me encanta el helado .	me encanta el chocolate de hielo .
no me creo lo que dice tom .	no creo lo que dice tom dice .
¿quién te ayudó ?	¿quién te ayudó ?
mi padre va a <unk> mañana alguna comida deliciosa .	mi padre me va a <unk> para mi padre para mí mañana .
tom <unk> algo de dinero del banco .	tom <unk> el dinero de dinero <unk> .
tom no tuvo ninguna oportunidad de hablar con mary .	tom no tuvo una oportunidad para que mary .
esta canción es muy popular en japón .	esta canción está muy <unk> en japón .
quedó a cargo del negocio de su padre .	él le ha estado en el padre .
¿cómo puedes estar tan <unk> ?	¿cómo puedes ser tan <unk> ?
mi padre estuvo durmiendo durante la película .	mi padre murió por los <unk> <unk> las <unk> de la película .
está en la oficina .	él está en la oficina .
tom está escuchando .	tom está <unk> .
tom va a ir al <unk> .	tom va a <unk> .
aún cuando la propuesta parecía ser una buena idea , ellos la <unk> .	ellos se <unk> una buena idea , se me gusta la buena idea .
supongo que ahora realmente estoy en problemas .	ahora estoy realmente <unk> en problemas .
<unk> aquí .	se <unk> aquí .
tom escribió un libro sobre pájaros .	tom tuvo un libro de un libro .
este vino está hecho de <unk> .	este vino <unk> de vino <unk> es <unk> .
¿es un pedido o una orden ?	<unk> un minuto ?
nos <unk> el uno al otro en la estación .	nos quedamos sin el uno al otro .
mira , sé que estás ocupado .	sé , está ocupado .
deberías <unk> tu <unk> .	deberías <unk> tu <unk> .
hace mucho calor .	es demasiado calor .
tom quería que te <unk> algo .	tom quería algo para ti .
no es mío .	no es mío .
ella empezó a <unk> al perro .	ella empezó a hablar al perro .
me quiero ir .	quiero irme .
te voy a extrañar .	te <unk> .
tom le preguntó a mary dónde vivía john .	tom le pidió a mary que john besándose mary .
parece que va a nevar .	parece que va a <unk> .
estamos entre amigos .	somos amigos .
probablemente tom <unk> .	tom estaba bromeando .
¿qué te gustaría hacer en el futuro ?	¿qué te gustaría hacer en el futuro ?
¿quiere una taza de café ?	¿querés ensalada una taza de café ?
la reunión se <unk> a lugar el próximo domingo .	el domingo <unk> el domingo .
ella habló con el presidente .	ella le <unk> a la <unk> .
el perro <unk> cuando nos <unk> .	cuando <unk> al perro <unk> .
mi hijo no me <unk> .	mi hijo no me <unk> a mi hijo .
es justo lo que quería .	lo que quería es exactamente .
tom recuerda .	tom <unk> .
conocí a tom .	sabía que tom .
me <unk> .	me <unk> .
ese perro es demasiado peligroso para <unk> <unk> .	ese perro es demasiado peligroso para pedir disculpas .
¿acaso viste lo grande que es su casa ?	¿cómo <unk> su casa ?
este problema es un verdadero <unk> .	este es un <unk> de <unk> <unk> .
¿cuándo volvió ?	¿cuándo se hizo a vuelta ?
solo quiero ir a casa y dormir un poco .	solo quiero dormir y a casa a casa .
tom <unk> que sus compañeros de clase se <unk> con más respeto .	tom <unk> con el uno de <unk> el uno al otro .
tom no tiene <unk> amigos .	tom no tiene amigos .
¿con cuánta comida debería estar <unk> a mi perro ?	¿cuánto debería estar <unk> mi perro ?
mi hermana tiene un trabajo .	mi hermana tiene un trabajo .
<unk> dónde se estaba escondiendo tom ?	¿sabes dónde estaba tom ?
él es un hombre en quien siempre puedes confiar .	el hombre es un hombre en un hombre .
les pedí que me <unk> el coche .	me pidió mi coche <unk> .
tom quiere <unk> .	tom quiere ver .
no comí desde el desayuno , estoy <unk> .	no he comido desde el desayuno y no me he comido .
su <unk> se ha hecho realidad .	su <unk> tiene <unk> .
tengo mucha sed .	estoy muy <unk> .
debiste haber dicho eso antes .	deberías haber dicho así .
tom <unk> los dientes .	tom <unk> la <unk> .
es un <unk> que tom siga vivo .	aún está todavía en una <unk> de tom .
¿se habla inglés en canadá ?	¿el <unk> en inglés ?
soy la esposa de tom .	soy el esposa de tom .
¿tiene una tarjeta de <unk> ?	¿tienes un <unk> <unk> <unk> ?
me estoy <unk> .	estoy intentando .
tom te ha mentido .	tom ha mentido .
la cuenta <unk> a tres mil dólares .	el <unk> a los <unk> tres veces a américa .
se ha <unk> mucho el <unk> de esa <unk> .	esa es muy <unk> <unk> .
descubrió una nueva estrella .	él <unk> un nuevo nuevo .
jamás <unk> con él .	nunca lo <unk> con él .
el éxito sólo depende de tu propio esfuerzo .	tu <unk> <unk> <unk> <unk> <unk> en la voz .
¿sabes lo hermosa que eres ?	¿sabes cómo lo <unk> ?
ella es una <unk> <unk> .	ella es un <unk> .
a ella le gusta la <unk> más que cualquier cosa .	a ella le gusta más que otra cosa .
tom pasó algunos años en boston cuando estaba en la universidad .	tom estaba en boston cuando <unk> en boston .
vamos camino a casa .	estamos en casa .
he oído que eres un buen <unk> .	creo que estás bien el tenis .
ella estaba <unk> en el sofá con los ojos cerrados .	ella se <unk> con un <unk> .
tom negó haber <unk> el <unk> .	tom tuvo el <unk> que había <unk> .
el colegio empieza el ocho de <unk> .	el colegio <unk> <unk> a la escuela .
tom vio a maría irse .	tom le <unk> a mary .
la semana pasada él estuvo enfermo .	él estaba enfermo enfermo .
<unk> <unk> <unk> el <unk> económico .	<unk> <unk> <unk> <unk> .
no te olvides de <unk> .	no me olvides .
<unk> pasada la medianoche .	<unk> después de la medianoche .
quiero que ella haga el trabajo difícil .	quiero hacer su trabajo en el trabajo .
<unk> al ladrón esta mañana .	este <unk> fue la mañana .
te estaba <unk> .	te <unk> .
<unk> , no <unk> tu opinión .	no <unk> tu <unk> , no <unk> .
conocen algo .	ellos conocen algo .
estaba intentando ocultar mis <unk> .	me <unk> intentando <unk> que mi <unk> .
<unk> con suerte .	eres en realidad .
estamos muy <unk> de ti .	estamos muy orgullosos de ti .
<unk> le dio al blanco en el primer <unk> .	el primer <unk> <unk> <unk> de su <unk> .
<unk> a alguien <unk> .	<unk> que <unk> .
el niño todavía está durmiendo .	la bebé todavía está vacía .
vemos la televisión juntos .	nosotros los <unk> juntos .
eso sería poner el carro delante de los caballos .	el <unk> será <unk> antes de que el <unk> .
¿cómo vas a <unk> este problema ?	¿cómo vas a resolver aquel problema ?
el arte es algo serio .	<unk> es una cosa .
yo voy a parís el próximo mes .	voy a parís .
mejor vete .	será mejor que te vayas .
tom no tuvo que ir a trabajar hoy .	tom no tenía que ir al trabajo .
<unk> a mi pregunta .	mi pregunta se <unk> .
¿cuántas veces en una hora <unk> los <unk> desde aquí ?	¿cuántas veces por la hora <unk> aquí ?
tom no quiso saber nada de mis problemas .	tom no quería que mi <unk> acerca de mi problemas .
me gusta viajar solo .	a viajar solo me gusta viajar .
dinos qué hacer a <unk> , por favor .	por favor , <unk> a <unk> a hacer por favor .
simplemente <unk> .	acaba de <unk> .
él es una persona <unk> .	él es una persona .
tom tiene algo que discutir con todos nosotros .	tom nos ha dejado algo de todo el trabajo con todos .
tengo una reunión muy importante .	tengo un importante muy importante .
ellas están conmigo .	son conmigo .
¿qué más quieres que diga ?	¿qué quieres hacer ?
quiero que <unk> .	quiero que vayas .
¿dónde está mi paraguas ?	¿dónde está mi paraguas ?
¿querés <unk> ?	¿te gustaría un <unk> ?
tengo que <unk> el <unk> .	tengo que comprar el pelo de <unk> .
sé la <unk> razón por la que se <unk> .	sé su verdadero <unk> para la educación .
ya no me importa .	no me he encontrado .
ella <unk> sola .	ella parecía solo .
tom es muy diferente .	tom es bastante listo .
mary <unk> el gran mapa sobre la mesa .	mary le <unk> las plantas del gran terremoto .
él se fue a quedar donde su <unk> .	él fue a su billetera con él .
ayer tom se quedó en casa todo el día .	tom ayer ayer ayer por su día .
no puedes ser amigo de todos .	no puedes amigos con todos los amigos .
él viajó con su familia a <unk> .	él <unk> con la familia .
no me iré hasta mañana .	no seré hasta mañana hasta mañana .
eso debería <unk> .	deberías estar suficiente .
es <unk> .	es <unk> .
<unk> <unk> a ayudar ?	<unk> estar con ayuda ?
lamento que hayas resultado <unk> en esto .	lo siento en <unk> .
si hubiera tenido tiempo suficiente , podría haber visto más de londres .	si tuviera suficiente tiempo , tuve más tiempo .
tom dijo que él estaba completamente <unk> .	tom dijo que estaba completamente confuso .
él tiene unos <unk> <unk> .	él tiene un <unk> .
tom puso su billetera <unk> del asiento del auto .	tom puso su coche <unk> .
es imposible no <unk> por su <unk> .	no es imposible <unk> por su <unk> .
le <unk> los zapatos .	ella tenía zapatos <unk> su zapatos .
tiene cerca del <unk> de un huevo .	es un huevo de la mano al lado de <unk> .
ella me recibió con una gran sonrisa .	ella me <unk> con una gran terremoto .
todavía está claro afuera .	todavía es <unk> .
vamos a ir a comer el viernes .	vamos a <unk> un <unk> para ir .
tom <unk> a mary .	tom <unk> a mary .
nuestro tren se <unk> de repente .	nuestro tren se <unk> .
ninguno de nosotros está en contra de sus ideas .	no nos conocemos de sus <unk> .
le daré una copia a cualquiera que la <unk> .	le <unk> a nadie a nadie que le <unk> una copia .
deberías dormir .	deberías dormir .
encontramos una hermosa <unk> azul en la <unk> más <unk> de la <unk> .	afortunadamente un <unk> de que <unk> , <unk> <unk> <unk> <unk> <unk> un <unk> <unk> <unk> .
<unk> todas las <unk> de <unk> <unk> .	<unk> todas las <unk> <unk> <unk> .
a tom le encanta contar <unk> .	tom le olvidó de <unk> a la mañana .
esto va a ser fácil .	esta es fácil ser fácil .
él sólo sabe hablar un poco de inglés .	solo puede hablar inglés .
no tengo ganas de <unk> .	no me gusta pintar .
primero el trabajo , después el <unk> .	<unk> antes de <unk> .
la familia ama mirar <unk> <unk> juntos .	a los <unk> <unk> a la familia .
lo deben haber sabido desde el <unk> .	debe haberlo dejado todo lo <unk> .
no quiero hablar con tom nunca más .	quiero hablar con tom no quieres hablar .
tom está a punto de irse .	tom está a punto .
<unk> entrar ?	¿te gustaría venir ?
no sé <unk> . es difícil .	no entiendo el <unk> .
lo hicieron ellos .	lo hizo .
hoy tom no quiere ver nada .	tom no quiere ver hoy .
no <unk> <unk> a tom .	no pude salir a tom .
ella estaba <unk> de rojo .	ella estaba en vano .
ya es suficiente para todos nosotros .	hemos suficiente de eso .
<unk> , ¿me puede <unk> el camino a la estación ?	¿me puedes <unk> el camino , pero me dejas ?
las <unk> <unk> son <unk> .	<unk> un <unk> <unk> <unk> <unk> <unk> <unk> <unk> <unk> .
ella me trata como si fuera un bebé .	yo me <unk> si le <unk> un bebé .
nunca <unk> que tom tuviera problemas .	nunca <unk> a tom en problemas .
eso pienso yo .	creo que creo que eso .
era bastante <unk> .	fue <unk> .
cuidado de no <unk> ese vaso .	<unk> no tocar esa película .
¿cómo pudo ocurrir eso ?	¿cómo podría pasar el colectivo ?
ahora no estoy estudiando .	no estoy estudiando .
tom no come carne , y mary tampoco .	tom no entiende nada de comer .
pídele a tom que me llame tan pronto como <unk> .	tom me hizo como <unk> a <unk> por <unk> .
cada vez que escucho esta canción , lloro .	lloro esta canción que escucho .
fue el mejor día de mi vida .	el mejor era el mejor día del día .
<unk> a mi pregunta con cuidado .	mi pregunta se dio con la pregunta .
tom está leyendo un libro .	tom es un libro de un libro .
murió a los <unk> años de edad .	él se <unk> cuando estaba viejo años .
no me despidieron . me fui .	no estaba despedido .
él tiene unos <unk> <unk> de <unk> dólares .	de <unk> , él tiene un millón de <unk> <unk> <unk> .
los <unk> se la pasan quejando del clima .	el clima siempre se <unk> al tiempo .
la voz me <unk> a mi madre .	mi madre me <unk> de la voz .
ellos <unk> a su país de los <unk> .	<unk> contra su <unk> contra la ley .
¿lo has hecho tú sola ?	<unk> usted ?
el perro debe de estar <unk> .	debe de estar <unk> el perro .
la casa de tomás y maría es muy <unk> .	tom y mary es muy <unk> .
tom está borracho .	tom es <unk> .
no <unk> mi paciencia .	no te vayas a mi familia .
ahora es tiempo para empezar a estudiar .	ahora es hora de acuerdo ahora .
tom se quitó los zapatos y los calcetines .	tom se sacó los zapatos y los zapatos .
la prisa es mala <unk> .	<unk> el gas .
mi hijo es <unk> .	mi hijo es un hijo <unk> .
en caso de emergencia llama a la policía .	en lugar le encanta el policía le encanta el policía .
me <unk> imposible acabar el trabajo en una hora .	es imposible que <unk> un trabajo en una hora .
no tengo toda la noche .	no tengo toda la noche .
él no es estúpido .	no es estúpido .
tengo una idea mejor .	tengo una idea mejor .
ni soy canadiense .	ni siquiera estoy canadiense .
" rápido " es el contrario de " <unk> " .	" " " " " " " " " " " " " es la <unk> . "
el tren ha pasado el cambio de <unk> .	el tren está <unk> por <unk> .
este cajón es de madera .	ese tipo es <unk> de madera .
ellos se van a encontrar mañana en el hotel .	ellos van a <unk> para jugar al hotel mañana .
mi padre <unk> cuarenta pronto .	mi padre va a ser <unk> .
¿qué es esa cosa ?	¿qué es eso ?
tom volvió a dormir .	tom se fue a dormir .
este <unk> es igual al que perdí hace una semana .	este es el mismo <unk> de que se <unk> una semana pasada .
el soldado <unk> herido en el suelo .	el muchacho se <unk> en el <unk> .
<unk> enamorado de tu esposa ?	¿todavía estás a tu esposa con tu esposa ?
tom tuvo un muy mal día .	tom tuvo un mal día muy malo .
ella <unk> el trabajo con facilidad .	ella <unk> al trabajo con el trabajo .
necesito descansar .	necesito descansar .
tom y mary <unk> seguir a john .	tom y mary <unk> a john .
la hice feliz .	ella le <unk> feliz .
tom no es tan <unk> como mary .	tom no es tan rápido como mary .
las <unk> son <unk> .	los <unk> son <unk> .
su situación <unk> .	el <unk> se <unk> por su <unk> .
tom fue mi <unk> al mando .	tom estaba <unk> de mi <unk> .
¿es tu primera <unk> en parís ?	¿es tu primera <unk> está en <unk> de <unk> ?
yo como queso .	yo <unk> .
no tienes que hablar .	no tienes que hablar .
<unk> de llorar como una niña !	a una chica de <unk> les gusta el <unk> .
yo entiendo tu punto de vista , pero aun así no estoy de acuerdo .	todavía no me <unk> de acuerdo , pero no estoy de acuerdo .
fuimos al museo .	hicimos al museo al museo .
me gusta la música <unk> .	me gusta la música .
estoy leyendo una carta .	leí una carta .
quiero volver a escalar el <unk> <unk> .	quiero <unk> de nuevo .
sabes lo que tienes que hacer .	debes hacer lo que te diga .
quiero llegar al aeropuerto <unk> a primera hora de la tarde .	quiero <unk> el año pasado de <unk> .
busqué mi cuarto .	miré a mi habitación .
¡no seas tan <unk> !	¡no seas tan <unk> !
¿quieres ver esto ?	¿querés quedarte esto ?
gracias por el consejo , tomás .	gracias a tom por la <unk> .
es un problema sin <unk> como lo <unk> .	es un problema , te ves un problema .
no creo que nadie haya <unk> lo que tom hizo .	no creo que nadie le <unk> tom .
¿has hecho trampa en un examen alguna vez ?	¿has visto un examen de primera vez ?
tom es hijo único .	tom es solo un niño .
si te <unk> después de clase , puedo ayudarte con tu <unk> .	si te puedo dejar las cosas , puedo <unk> de tu clase de <unk> , te <unk> con tu ayuda , te <unk> , te <unk> de ayuda .
sé que no pasará otra vez .	sé que no volverá a pasar .
tom le pasó la <unk> a mary .	tom <unk> la cara de mary .
mi padre sí que juega al golf , pero no lo hace bien .	mi padre no le <unk> bien , pero a la padre .
<unk> durante la cena .	<unk> a cenar .
él es demasiado mayor para ella .	es demasiado vieja para ella .
lo ayudé a <unk> la calle .	lo esperé a <unk> .
¡qué horrible !	¡qué <unk> !
ellos <unk> algún <unk> .	ellos se <unk> algunas <unk> .
¿qué estabas diciendo ?	¿qué estabas de <unk> ?
le pido <unk> que lo haga con cuidado .	te lo <unk> a hacer con <unk> .
tom <unk> a mary su mejor amiga .	tom cree que mary le <unk> su amigo a su amigo .
a las <unk> <unk> les encanta comer <unk> mientras <unk> de <unk> .	<unk> <unk> a su <unk> de <unk> <unk> <unk> <unk> <unk> <unk> <unk> <unk> en <unk> .
necesitamos vuestra ayuda .	necesitamos tu ayuda .
se puede llegar a la ciudad en auto en menos de 20 minutos desde aquí .	el teléfono puede ser más tarde que se puede hablar en el <unk> .
él se decidió a estudiar de <unk> .	él tomó <unk> para su dolor .
el hombre que conociste en la estación es mi padre .	el hombre que te ha dado es el padre .
a pesar de que pueda ser inteligente , no es <unk> .	puede que no es <unk> , él es <unk> .
<unk> fútbol después de la escuela .	<unk> después de que la escuela .
por favor <unk> las reglas de la escuela .	por favor , <unk> las reglas .
parece que tom disfruta verdaderamente de estar aquí .	tom parece que parece estar muy <unk> aquí .
tom se hizo <unk> una <unk> para la <unk> .	tom se ha <unk> un <unk> .
¿eres un <unk> del <unk> ?	¿estás <unk> de <unk> ?
el accidente <unk> el tráfico .	el accidente <unk> <unk> .
esta vez lo haré a mi manera .	lo haré de mi tiempo para hacer eso .
<unk> gato vino de <unk> pájaros .	el gato fue a <unk> de clases .
te doy 5 dólares .	te <unk> cinco dólares .
tom ha estado trabajando como <unk> desde que se graduó de la universidad .	tom ha estado <unk> el <unk> de <unk> desde el <unk> de <unk> .
<unk> la ley .	él dejó la ley .
¿te gustaría venir ?	¿te gustaría venir ?
lo <unk> a decir la verdad .	lo <unk> <unk> a la verdad .
tom se siente mal por mary .	tom <unk> a mary .
tom nunca miró de vuelta .	tom nunca <unk> de vuelta .
la cena fue <unk> .	la cena estaba abierta .
<unk> , la causa de la enfermedad es <unk> .	en el <unk> , la mano está <unk> de la mano .
ella dejó su trabajo el mes pasado .	ella fue el trabajo en el trabajo .
este camino es muy <unk> para que <unk> los <unk> .	este <unk> es demasiado para <unk> para <unk> para <unk> para los <unk> para <unk> para <unk> para los <unk> para <unk> .
yo puedo estar equivocado .	podría ser malo .
tengo que <unk> de <unk> este dinero .	me he ido a tener que <unk> este dinero .
¿tienes un libro ?	¿tienes un libro ?
estoy <unk> por la tecnología .	estoy <unk> para la <unk> .
a tom le encanta escuchar música <unk> .	a tom le gusta <unk> <unk> la música .
ella <unk> a <unk> .	ella <unk> por <unk> .
tom ha hecho un excelente trabajo .	tom ha <unk> un trabajo <unk> .
¿te despidieron de tu último trabajo ?	<unk> que tu trabajo te <unk> del trabajo ?
él adora <unk> a la gente .	solo acaba a la gente a <unk> .
esa película es para niños .	esa mujer es muy <unk> .
tom come la misma comida día tras día .	tom y mary <unk> el día en el día .
no me gusta nada el béisbol .	no me gusta todo el béisbol .
la libertad no es <unk> .	el <unk> no es <unk> .
¿qué dijo ?	¿qué le pasó ella ?
estaba equivocado .	estaba mal .
su casa fue <unk> por diez mil dólares .	su casa fue diez veces a <unk> .
nosotros podemos pagar .	nos podemos <unk> .
se fue a la tienda en bicicleta .	él fue a su <unk> en bicicleta .
tienes un <unk> de <unk> todo .	tienes un <unk> de todo lo que te <unk> .
estoy teniendo problemas para <unk> .	estoy <unk> a <unk> .
algunas personas dicen que comer tarde por la noche es malo para la salud .	algunas personas por la gente de que tu presión de comer a <unk> hace diez años .
ella sabe qué hacer ahora .	ella sabe qué hacer .
mis padres son <unk> , pero vinieron a <unk> en el <unk> .	ellos están a mis padres , pero a <unk> en <unk> a los <unk> .
mi hermana menor se casó antes de los 20 .	mi hermana se <unk> con su hermana .
estamos <unk> más <unk> .	estamos más <unk> .
<unk> la <unk> con ambas manos .	<unk> <unk> las manos en la manos .
<unk> café ?	<unk> beber café ?
será mejor que no te <unk> con ella ahora .	no deberías ver ahora .
no quiero ver a tom .	no quiero ver a tom .
mi madre está ocupada preparando la cena .	mi madre está ocupado de los <unk> .
estaré de vuelta en menos de cinco minutos .	me pregunto en menos de menos de menos de menos .
tom sabe cómo manejar una <unk> <unk> .	tom puede <unk> un <unk> .
quédate ahí .	quédate ahí .
¿hay algo que <unk> hacer ?	¿hay algo que podemos hacer ?
¿quién habla francés ?	¿quién habla francés ?
¿tienes coche ?	¿tienes un coche ?
<unk> de cenar .	solo comimos <unk> .
tom se las <unk> todas a una sola carta .	tom puso sus huevos en su huevos .
tom escuchó la alarma .	tom escuchó <unk> la mesa .
ven aquí antes de las siete .	las siete de las siete de las siete .
su cara <unk> .	su cara <unk> <unk> .
<unk> tiempo .	le <unk> tiempo .
¿dónde dijiste que <unk> esto ?	¿dónde lo hiciste ?
¿por qué no le <unk> su consejo ?	¿por qué no le <unk> su inglés ?
ella nos dio un regalo .	ella nos dio un obsequio .
él ha ido a la biblioteca .	él se ha ido a la biblioteca .
por favor , siéntate .	por favor , <unk> .
no lee más que novelas .	ella <unk> no <unk> nada .
ella se suicidó <unk> de un puente .	ella se dio la caja , ella se dio a la revista .
anoche llovió mucho .	tuvimos una noche anoche .
yo <unk> ropa por internet .	<unk> muy <unk> .
nosotros <unk> a la casa <unk> .	nosotros los <unk> <unk> <unk> <unk> .
tom no parece estar muy interesado .	tom no le <unk> muy <unk> .
hace calor en la habitación .	la habitación está <unk> .
no estoy de acuerdo .	no estoy de acuerdo .
está claro que te van a <unk> si no <unk> más .	no tienes más <unk> .
lo que a ti te parece simple , a mí me parece <unk> .	parece que te <unk> qué <unk> lo que te <unk> .
¿por qué debería ayudarte ?	¿por qué debería ayudarte ?
nueva york es una de las ciudades más grandes del mundo .	<unk> es uno de los libros más grandes del mundo .
me <unk> que llueva mañana .	me temo que pueda llover mañana .
tom le preguntó a mary si él podía tomar <unk> su bicicleta .	tom le preguntó a mary si le había dado su bicicleta .
me alegro mucho de <unk> .	me alegro de verte muy <unk> .
les dije que me <unk> otro boleto .	me dijo que <unk> otro otro otro día .
¿me <unk> qué debo hacer <unk> ?	¿qué debería <unk> de mí ?
tienes que dar cuenta de tu <unk> .	tienes que <unk> tu <unk> para la <unk> .
tom se rió de algunos de los chistes de mary , pero pensó que algunos de ellos no eran muy <unk> .	tom no sabe muy <unk> , pero mary .
¿cómo sabes que pasará eso ?	¿cómo sabes que <unk> eso ?
<unk> en mi habitación .	me <unk> en mi cuarto .
nadie le <unk> .	nadie lo <unk> a él .
fuiste <unk> .	<unk> <unk> .
todavía tengo mis dudas .	todavía tengo mi dudas .
su discurso me <unk> .	su <unk> me dio su discurso .
la <unk> <unk> es mía .	el <unk> se ha <unk> el mío .
por favor , <unk> la puerta .	por favor , <unk> la puerta .
no pude ir a su fiesta de cumpleaños .	no estaba capaz de <unk> a su cumpleaños .
solo pregunto .	solo estoy <unk> .
después del desayuno fuimos a <unk> .	después de que <unk> , <unk> después de caminar .
tom tiene que volver a boston mañana .	tom tiene que ir a boston mañana .
parece ser que tom ha intentado <unk> .	tom tiene el que <unk> <unk> <unk> <unk> .
él dice que no se <unk> de fumar .	no dice que <unk> de fumar .
<unk> a ti mismo .	<unk> .
no puedo estar más de acuerdo .	no puedo acuerdo de acuerdo .
ella esperó a que la <unk> .	ella lo esperó para él .
¿cómo pueden estar tan <unk> ?	¿cómo puedes ser tan <unk> ?
a él le encanta viajar .	a él le encanta el <unk> .
no quiero escuchar tus <unk> nunca más .	no quiero <unk> de tu ordenador .
tom está confundido .	tom es <unk> .
ayúdame a elegir un sombrero que <unk> con mi vestido nuevo .	por favor , <unk> un nuevo vestido que mi nuevo vestido .
eso <unk> todos los días , ¿no es así ?	entonces todos los días no es casi todos los días ?
compré este libro para mí , no para mi esposa .	lo compré no compré mi esposa , yo compré .
eres demasiado joven para morir .	eres demasiado joven para ti .
nos quedamos toda la noche hablando .	<unk> toda la noche .
prefiero comer otra cosa .	prefiero algo más .
mientras más <unk> , más nos <unk> cuenta de lo poco que sabemos .	nosotros sabemos más importante , lo <unk> el poco más .
te veré cuando vuelva .	te veré de volver a volver .
he <unk> mi teoría .	me <unk> de mi <unk> .
nunca volví a hablar con él .	nunca lo <unk> con él .
¿quién va allí ?	¿quién se va de <unk> ?
ese <unk> se <unk> con la pena de muerte .	esa muerte es <unk> por la muerte .
la mitad de los estudiantes estaban <unk> .	los estudiantes estaban <unk> .
me <unk> por no llevar puesto el <unk> .	no llevaba una <unk> para <unk> .
voy a dormir en el piso .	<unk> el piso .
todas las mujeres <unk> que tom era realmente apuesto .	tom estaba muy <unk> por todos los <unk> .
mi inglés no es nada bueno .	mi inglés no es bueno bueno bueno bueno a mi inglés .
esa casa me pertenece a mí .	eso me pertenece .
la pequeña <unk> llegó a la vista .	las <unk> se <unk> a los <unk> eran <unk> .
cuando <unk> manos con alguien , debes <unk> a los ojos .	debes hacer un gran manos de <unk> , <unk> .
debemos obedecer las reglas .	tenemos que <unk> las reglas .
ya me siento mucho mejor .	ya siento mucho mejor .
¿qué más puedes hacer ?	¿qué puedes hacer más <unk> ?
se casó a los <unk> .	ella se casó cuando estaba casado .
tom se preguntaba lo mismo .	tom no pudo haber dicho la misma cosa .
<unk> tus <unk> !	<unk> tu <unk> !
él no pudo cumplir la promesa que hizo a su padre .	él no pudo encontrar el padre para que su padre .
no significa que <unk> de hacerlo .	no lo haré decir eso .
ella tiene vino .	ella tiene vino .
está claro que es rico .	es claro que él es <unk> .
había <unk> que <unk> <unk> su <unk> .	los <unk> <unk> <unk> se <unk> de <unk> ahí .
mi amigo <unk> ayudar a mi hijo con sus estudios .	mi hijo le <unk> el hijo a mi hijo con mi hijo .
tom siguió escribiendo .	tom se quedó dormido .
ella hablaba mientras <unk> .	ella le echó una película .
él solo tenía treinta y seis años .	solo estaba <unk> años .
tom no tiene enemigos .	tom no tiene ninguna <unk> .
tom tiene que buscar un trabajo .	tom tiene un trabajo para un trabajo .
supongo que <unk> <unk> con quién estaba anoche .	quiero que me <unk> con quién te <unk> quién me llamaste .
tom todavía vive con su madre .	tom todavía vive con su madre .
espera a la policía .	<unk> por la policía .
puedes venir con nosotros .	puedes quedarte con nosotros .
el <unk> de <unk> es <unk> .	el <unk> es <unk> para la <unk> .
dicen que una mirada vale más que mil palabras .	<unk> es más fácil que una pena que <unk> .
no está bien intentar <unk> las ideas <unk> a los demás .	deberías <unk> no deberías leer .
no <unk> ver la diferencia .	yo no veo a ver la diferencia .
también hablo francés .	yo también también hablo francés .
una mujer escribió 30 libros sobre cómo ser feliz , y entonces se suicidó .	para un poco de vez , por favor .
tom se <unk> en la <unk> de arriba .	tom <unk> a la <unk> .
tom es un chico malo .	tom está mal un mal .
ellos <unk> cuando están en peligro .	cuando están en el peligro , ellos están <unk> .
esta copia está llena de errores .	esto es de soldados <unk> .
¿te ha visto alguien ?	¿alguien lo viste ?
tom , ¿estás dormido ?	¿estás bromeando , tom ?
de verdad que necesito un <unk> ahora .	ahora necesito un realmente <unk> .
el <unk> fue <unk> en el aeropuerto .	el <unk> fue al <unk> en <unk> .
tom no es un chico <unk> . de hecho , él trabaja duro .	tom está tan <unk> a un <unk> de <unk> .
tom <unk> su fiesta hasta que maría saliera del hospital .	tom se subió al hospital la fiesta la fiesta .
¿quieren tener hijos ?	¿querés niños quieres niños ?
ellos están <unk> a aprender inglés .	ellos están bien a aprender inglés .
<unk> a tom , a pesar de que no fue su culpa .	tom no era de que <unk> <unk> .
hoy es fiesta .	hoy es un buen calor .
tenemos el problema <unk> .	tenemos el problema .
a él le gusta mucho el béisbol .	a él le gusta mucho el béisbol .
mis padres no me <unk> volver a ver a tom .	tom no me dio a ver a ver a mis padres de nuevo .
él se <unk> cuando toca la guitarra .	él es el <unk> cuando está en la <unk> .
se <unk> las clases .	la escuela está <unk> .
yo soy de <unk> .	estoy de <unk> .
no es una buena persona .	ella es una buena buena buena buena .
<unk> acerca del <unk> de tom ?	<unk> el <unk> de tom ?
quizás tom estaba escondiendo algo .	tom estaba muy <unk> .
hace diez grados bajo cero ahora .	ahora es diez años .
esta fiesta está <unk> .	este es <unk> .
tom <unk> segundo .	tom dejó la tarta .
fue una gran fiesta .	esa <unk> fue una fiesta .
soy de <unk> .	estoy de <unk> .
la niña es chica para su edad .	la chica que ella está <unk> a su edad .
no quiero vivir contigo .	no quiero vivir con vos .
mamá nos ha comprado un <unk> .	compró un <unk> por <unk> .
tienes las manos <unk> .	tienes las <unk> .
¿y tu bebé ?	¿dónde está tu bebé ?
los mejores <unk> son <unk> .	los <unk> son <unk> .
no quiero que se <unk> tom .	no quiero <unk> a tom .
ella le <unk> a su hermana .	ella le <unk> a su hermana .
¿por qué no viniste ayer ? te esperé mucho rato .	¿por qué no viniste a nadie ayer ?
él se <unk> en el suelo .	él se <unk> en el piso .
<unk> están buenas .	<unk> son <unk> .
¿cuál es la comida a la que jamás <unk> ?	¿qué es una comida de comida que quieres ?
¿cuándo <unk> para boston ?	¿cuándo te <unk> a boston ?
<unk> no sé cómo seré capaz de cumplir con todos los <unk> !	¡no sé cómo <unk> todos mis <unk> !
ella pesa mucho más que él .	ella es mucho más joven que él .
¿tienes un <unk> ?	¿tienes un <unk> ?
<unk> que no <unk> muy ocupados .	no me lo he comido .
¿ella te enseñó la foto ?	¿le <unk> la foto ?
esta mesa está <unk> de buen <unk> .	este es un buen <unk> de <unk> de <unk> .
es la última vez que <unk> un regalo .	este es el último tiempo que <unk> un regalo .
lo importante es tener tu propio pasatiempo .	<unk> es la cosa que <unk> importante .
todavía no he <unk> .	aún no he comido todavía .
ella habla con <unk> .	ella habla ruso .
tuve que darle una oportunidad .	tuve que <unk> un <unk> .
¿este bus se <unk> al museo ?	<unk> ir a este museo ?
lamento haberle <unk> tantos problemas .	estoy problemas para <unk> mucho .
lamento esas <unk> palabras .	las <unk> <unk> <unk> por las palabras .
ella <unk> inglés .	ella <unk> inglés .
puse el <unk> en el <unk> .	<unk> la <unk> .
quiero que mis hijos <unk> lo mejor .	quiero que <unk> todo lo que quiero pasar .
por favor no <unk> mi <unk> .	por favor , no te <unk> de mi <unk> .
<unk> el coche por favor .	por favor , préstame tu coche .
<unk> a tom y <unk> lo que <unk> de <unk> .	tom me pidió qué <unk> y me <unk> qué <unk> .
tú pareces un <unk> .	te ves un <unk> como te gusta .
me fui a la cama más tarde de lo habitual .	me fui a la cama que <unk> más tarde .
¿dónde estabas cuando ocurrió la <unk> ?	¿dónde estabas en el <unk> ?
es posible que eso sea cierto .	puede ser verdad .
ayer comí pescado .	comí otra vez ayer .
la verdad puede ser más <unk> que la mentira .	el <unk> puede ser más fácil ser más que la verdad .
agradecería que me <unk> tan pronto como le sea posible .	ojalá <unk> tan pronto como pueda como una <unk> tan pronto como sea posible .
quiero unos zapatos <unk> , no <unk> .	quiero que no se me <unk> .
detesto perder .	odio los <unk> .
es un <unk> sin corazón .	él es un <unk> .
¿qué lugares <unk> visitar ?	¿qué te gustaría saber lo que quieres hacer ?
vayamos a <unk> una bebida .	<unk> que te <unk> un <unk> .
¿es usted japonés ?	¿estás japonés ?
tengo una <unk> de trabajo mañana a las dos de la tarde .	tengo un trabajo en el trabajo para <unk> .
se nos <unk> el agua .	hemos <unk> de agua .
su casa se <unk> en la colina .	su <unk> se ha <unk> en la lengua .
ella <unk> haber visto al hombre .	ella vio que <unk> el hombre .
tom tiene piernas <unk> .	tom tiene <unk> .
es sabido que fumar es malo para tu salud .	es tu sueño que <unk> es fácil .
deseo que mi sueño se hiciera realidad .	ojalá <unk> mi sueño ser verdad .
los <unk> de tráfico <unk> todos los días .	cada día todos los <unk> todos los días .
les vimos irse .	nos vimos <unk> .
no tengo tiempo para eso .	no he comido por esa tiempo .
he estado buscando mis llaves todo el día .	he estado <unk> mis llaves por todos mis llaves .
no quería creer las cosas que tom dijo acerca de maría ayer .	dije que tom no quería mary acerca del cosas .
¿cómo se llama ?	¿cuál es su nombre ?
tomó un <unk> a <unk> del bosque .	él tomó una <unk> la mesa .
tom probablemente sabía quién era yo .	sabía que tom sabía quién estaba <unk> .
deja libre la tarde del próximo sábado por favor .	por favor , <unk> a la casa el colegio .
ella me <unk> una tarta .	ella me hizo un torta .
tom sabe lo que tiene que hacer .	tom sabe lo que sabe qué hacer .
soy más rápida que ustedes .	soy más rápido que tú .
el escritorio está hecho de madera .	el escritorio está <unk> de madera .
ella hizo feliz a su madre .	ella ayudó a su madre .
llévate mi coche .	mi coche se <unk> .
si me <unk> hablado antes al respecto , yo podría haber estado libre . como sea , mañana tengo planes de volver a casa .	si lo dije que <unk> a casa , <unk> a casa mañana .
esta y esa son dos <unk> diferentes .	esta es dos y <unk> <unk> .
el verano <unk> .	el verano tiene verano .
¿no tienes frío ?	¿no te has frío ?
¿cómo estuvo el <unk> ?	¿cómo estuvo el boda ?
le dio una respuesta <unk> .	él dio un respuesta .
¿quién es tu profesor de francés ?	¿quién es tu profesor ?
ambas están bien .	los dos son bien .
<unk> mis ojos y <unk> mi cabeza .	me <unk> los ojos y me <unk> .
tom se sentó junto a mary en el concierto .	tom se sentó al concierto a mary al lado de la siguiente .
¿con <unk> viven ?	¿con quién te quedarás ?
¿cuántos años tienen vuestros hijos ?	¿cómo son los niños ?
el <unk> de esquí da <unk> .	los <unk> se parece a la <unk> .
la navidad es el <unk> de <unk> .	navidad es un día <unk> .
yo lo tomé prestado .	lo hice .
lo siento por ti .	te siento .
tom normalmente solo lee los <unk> .	tom solo <unk> la <unk> .
yo no quiero abrir la ventana .	no quiero dejar la ventana .
ella estaba entre los niños .	ella le echó una <unk> el chicos .
los dos somos <unk> .	estamos a los dos estamos <unk> .
sus bromas nos <unk> <unk> de risa .	su <unk> nos había <unk> en su <unk> .
tom estuvo pensando en lo que mary le había contado .	tom le dijo a mary que había comido de lo que había pasado .
sois demasiado jóvenes para morir .	eres demasiado joven para ti .
¿cuántas preguntas había en el examen ?	¿cuántas niños estaban <unk> en el examen ?
se requiere <unk> que ellos <unk> sus <unk> .	hay una <unk> para <unk> de <unk> por su <unk> .
si yo fuera tú no iría allí .	no pude ir ahí por si no quieres allí .
a tom no le fue bien en el examen .	tom no hizo el examen por la peor .
tuve un día realmente duro .	tuve un día muy día .
es fácil para ti .	es fácil .
sus amigos están allá dentro .	hay amigos en tus amigos .
tom le dio un beso <unk> a maría .	tom le dio un <unk> a mary .
escriba un <unk> con <unk> de cuatro <unk> .	<unk> a los <unk> de tres <unk> con un <unk> .
¿ya encontraste a tom ?	¿has hablado ya tom ?
un niño está <unk> el <unk> .	<unk> es una <unk> a jugar .
¿en qué año <unk> ?	¿qué te <unk> del año pasado ?
debe haber un malentendido entre nosotros .	alguien habrá visto alguna vez .
estoy <unk> esa taza .	estoy <unk> de esa copa .
ojalá hubiera salido de casa cinco minutos antes .	si solo tuve cinco minutos a casa , tuve cinco minutos .
todas ellas entraron .	todos <unk> .
prefiero ir a la montaña en verano .	yo preferiría ir a la <unk> en verano .
tu libro está sobre el escritorio .	tu escritorio está en el escritorio .
soy <unk> .	estoy <unk> .
él me golpeó en la cabeza .	me dio el cuarto en contacto .
ya me había tomado un café .	ya he dejado un café .
ya no hay un sólo lugar seguro en japón .	hay un lugar no está en japón .
aún tenemos algo de dinero .	todavía hemos <unk> un poco de dinero .
le di al <unk> todo el dinero que tenía .	tuve el dinero me había dado a la <unk> .
hoy hace bueno .	hoy es muy bien hoy .
puedo pagar por <unk> .	yo puedo <unk> .
<unk> absolutamente seguro !	<unk> !
él murió <unk> en la guerra de <unk> .	murió en el <unk> de <unk> .
<unk> al mediodía .	tuvimos un gran mediodía .
<unk> de nuevo pronto .	<unk> pronto con nuevo .
mi ciudad natal es muy bonita .	mi <unk> es muy viejo .
usted es buena .	eres bueno .
no os conozco .	no sé .
estudia inglés todos los días .	cada día todos los días .
yo <unk> tres <unk> ayer .	ayer me quedé a las tres días .
¿sabes <unk> en <unk> ?	¿puedes <unk> <unk> en <unk> ?
hace demasiado calor .	es demasiado calor .
¿crees que tom <unk> éxito ?	¿crees que tom <unk> ?
pensé que tom vendría a <unk> .	pensé que tom me <unk> por mí .
<unk> las sobras al perro .	<unk> al perro a la perro .
el profesor <unk> al muchacho por su <unk> .	el profesor <unk> a su profesor .
¿sabes cómo funciona esta máquina ?	¿sabes cómo esta máquina ?
los niños <unk> el <unk> y el guardia los <unk> .	los niños y los <unk> en el <unk> de <unk> .
él llegó a la estación a las cinco .	él llegó a la estación .
yo era demasiado rápido .	yo estaba demasiado rápido .
estaba <unk> por escapar .	él fue <unk> a <unk> .
<unk> usted su idea con más <unk> .	<unk> una idea más idea .
tom piensa que la respuesta es sí .	tom cree que la respuesta está <unk> .
su aliento huele a queso de cabra .	su <unk> les gusta la mente .
sus <unk> se <unk> al oír el <unk> .	ella <unk> <unk> cuando su <unk> <unk> <unk> <unk> <unk> <unk> <unk> .
japón importa varias <unk> <unk> desde el extranjero .	japón <unk> <unk> <unk> de japón <unk> <unk> <unk> .
yo me <unk> aquí hasta que él <unk> .	voy a <unk> aquí .
¿puedes dejar esto conmigo por un rato ?	¿me <unk> un rato con esto ?
estoy seguro de que tom <unk> <unk> a mary de ir a boston con él .	le estoy seguro de que tom <unk> a mary con john .
la gente le <unk> a la guerra .	la gente tiene miedo de la guerra .
tom quedó sorprendido de que mary se <unk> tanto .	tom <unk> que mary era muy <unk> .
la compañía tiene un capital de un millón de dólares .	la compañía ha roto una <unk> .
tienes que estar bromeando .	¡tienes que estar muy <unk> !
a los <unk> les gusta viajar en grupo .	a los <unk> le gusta viajar .
tom <unk> a su madre para que le <unk> el coche durante el fin de semana .	tom <unk> a su madre al auto .
tom no se <unk> nunca .	tom nunca <unk> .
él es un <unk> muy <unk> .	él es un <unk> .
su nombre , por favor .	por favor , <unk> tu nombre .
aquí es donde él se suicidó .	este es el lugar que se <unk> .
tiene usted que <unk> esos <unk> .	tienes <unk> que <unk> <unk> <unk> .
los <unk> <unk> siempre mirando hacia la <unk> .	las <unk> siempre se <unk> siempre <unk> .
quiero ir a francia .	quiero ir a francia de francia .
nuestro <unk> se <unk> .	nuestra <unk> está <unk> .
¿cuánto <unk> él ?	¿cómo está <unk> ?
¿cuántos <unk> tienes en tu <unk> ?	¿cuántas <unk> has <unk> tu <unk> ?
la música de <unk> es bella .	la <unk> es <unk> <unk> <unk> .
por favor habla más alto para que todo el mundo pueda oírte .	por favor , <unk> tan <unk> .
ellos siempre estaban bromeando .	siempre se <unk> .
el <unk> para la tos sabe a <unk> .	el <unk> tiene un <unk> <unk> <unk> .
esto es un <unk> .	esto es un <unk> .
no pasó mucho antes que nos <unk> <unk> otra vez .	no hicimos una vez que era <unk> .
tengo que <unk> .	tengo que <unk> .
pensé que eras mi mejor amigo .	pensé que habías dicho que mi amigo .
¿cuánto tiempo te <unk> pintar mi casa ?	¿cómo le <unk> a mi casa ?
pronto <unk> .	pronto <unk> el día .
es cruel .	eres <unk> .
¿no le <unk> una carta ?	¿no te dio una carta ?
era lo suficientemente <unk> .	era lo suficientemente <unk> .
<unk> la radio , por favor .	por favor , <unk> la radio .
deja que te dé mi tarjeta de <unk> .	déjame que me <unk> en mi <unk> <unk> .
algunos de ellos son <unk> , y algunos son <unk> .	algunas son <unk> , los <unk> son <unk> y los <unk> son <unk> .
estoy cansado y quiero irme a casa .	estoy cansado y quiero <unk> a casa .
tom <unk> que lo que hizo estuvo mal .	tom hizo eso que estaba mal .
la sangre era de un rojo <unk> .	el sol estaba <unk> .
te di un libro .	te di un libro .
mi tía <unk> de buena salud durante toda su vida .	mi abuelo <unk> <unk> la vida a la vida .
su manera de hablar me <unk> .	su <unk> me ha <unk> de <unk> de sus empleados .
con tus <unk> , deberías ser capaz de encontrar un trabajo para tom .	deberías estar <unk> con tu trabajo , tom .
es la mejor forma de resolver el problema .	es el mejor problema , <unk> el problema .
tom le dijo a mary que se iba a <unk> , pero que no tuvo el <unk> para hacerlo .	tom dijo que no tenía el <unk> , pero mary no quería <unk> .
sabía que te gustaría .	me gustaría que <unk> .
ha vivido aquí toda su vida .	está prohibido <unk> aquí .
nos vemos la próxima semana , tom .	tom te ves por la semana .
¿qué tienes en el menú hoy ?	¿qué tienes en la abuela ?
<unk> <unk> sin el aire .	sin aire morimos .
¿puede darme algunas de <unk> ?	¿me pueden un poco de estos ?
no me hagas sentir mal por hacer lo que hice .	no me siento tan malo acerca de mí .
las <unk> no se <unk> y tuve que entrar por el <unk> .	no tuve que la <unk> por la <unk> , así poder sentarnos .
te veré mañana en el desayuno .	te veré mañana a ver mañana .
no estés tan <unk> .	no seas tan <unk> .
el próximo mes hará diez años que vivo aquí .	he vivido aquí durante diez años .
ayer la pasé verdaderamente bien .	ayer tenía un buen tiempo para la guitarra .
aquí estarás seguro .	debes aquí .
se fue después de que <unk> .	él tuvo el almuerzo de almorzar .
no hay absolutamente ninguna manera en que yo vaya de viaje solo .	no entiendo por esa manera de viaje .
él es un <unk> .	él es un <unk> .
también es una <unk> .	ella es un <unk> <unk> .
la <unk> es una <unk> .	el <unk> es un <unk> .
en cuanto llegue , <unk> .	déjame saber que él me va a venir .
gracias por preocuparte de mí .	gracias por tu <unk> .
deme una taza de té , por favor .	por favor , <unk> un té de té .
él vive ahí solo .	él vive solo .
mi esposa <unk> dinero como si yo fuera el hombre más rico en la ciudad .	<unk> que mi <unk> <unk> <unk> <unk> <unk> <unk> <unk> <unk> <unk> <unk> <unk> <unk> le en la ciudad .
¿qué pasa conmigo ?	¿qué me ha pasado ?
¿cuándo quieres que esté de vuelta aquí ?	¿querés que me <unk> aquí ?
alguien entró en la habitación .	alguien habla el cuarto .
veamos cómo <unk> tom a eso .	por qué <unk> a tom de <unk> que se le <unk> .
me agrada tom .	me gusta tom .
demasiado está en riesgo .	el único es demasiado .
déjame ver esa lista .	déjame ver eso me dio eso .
ya no somos niños .	no estamos a los niños .
nunca <unk> construir una casa en esta área .	nunca me <unk> un edificio en esta casa .
<unk> la pregunta .	<unk> la pregunta .
realmente pensé que <unk> .	pensé que ibas a <unk> .
estoy estudiando música .	estoy estudiando música .
yo he escrito este libro .	esto libro este libro .
había una multitud en el parque .	había un <unk> de gente ahí en el parque .
me pregunto si estará en casa .	me pregunto si está en casa .
lo siento de verdad .	estoy realmente .
el tiempo va <unk> a <unk> que <unk> el día .	el clima se fue a <unk> en el día y el día en el día .
parece que él no sabe acerca de mi <unk> con mi padre .	él me parece que no sabe por mi padre y no es el <unk> de mi padre .
iré a francia a estudiar pintura .	voy a <unk> para estudiar francia .
tomé un taxi porque el bus <unk> atrasado .	me <unk> el taxi para el autobús .
tom no tiene nada que ver con esto .	tom no tiene que hacer nada con esto .
no <unk> su broma .	no me <unk> su broma .
gracias por tu <unk> .	gracias por tu <unk> .
por favor , <unk> en <unk> . estoy ocupada .	por favor , me <unk> solo .
me levanté más pronto de lo normal para coger el primer tren .	me levanté <unk> del tren .
ahora me <unk> a mí .	ahora me está ahora .
tom dice que oyó a mary y john <unk> .	tom dice que mary y john besándose .
tomás se rió en mi cara .	tom se rió en mi cara .
para más información , <unk> nuestro sitio .	nuestro sitio web , nuestra reunión se <unk> .
déjame probar .	déjame <unk> .
pensé que habías dicho que te gustaba probar cosas nuevas .	pensé que te <unk> cosas nuevas .
es tu <unk> .	es tu <unk> .
la estás <unk> .	lo estás <unk> .
creo que volveré el lunes de la semana próxima .	me pregunto el lunes .
¡qué buen <unk> !	¡qué buena idea !
<unk> tu leche .	tu leche se <unk> la leche .
tom le sacó punta a un lápiz .	tom <unk> una <unk> .
esa información , <unk> , es correcta .	generalmente , el lago es <unk> .
no soy tan rico como era .	no soy tan pronto como yo estaba tan rápido como yo .
dile que estoy nadando .	estoy <unk> a su <unk> .
<unk> tu aliento .	no vale la pena <unk> .
tienes suerte de que no te <unk> .	usted no te <unk> un poco de <unk> .
lo aprendí hace mucho tiempo .	aprendí esa hora hace mucho tiempo .
estos guantes <unk> <unk> sus manos .	estas <unk> de manos <unk> su manos .
<unk> qué <unk> ahora ?	¿qué vamos ahora ?
no te <unk> tanto por eso , la vida tiene sus <unk> .	no es tan <unk> y la vida <unk> de su vida .
la madre cortó la torta en ocho <unk> .	los <unk> <unk> <unk> a la madre a la <unk> .
estoy <unk> .	estoy trabajo .
tom le arrojó la <unk> a mary .	tom dejó la pelota <unk> .
todavía nadie lo sabe .	ese <unk> <unk> es un misterio .
<unk> es la capital de <unk> .	<unk> es <unk> de <unk> .
es imposible que el pájaro <unk> de la trampa .	es imposible <unk> por el diccionario .
he escrito todos los <unk> hasta el treinta y uno .	he <unk> todo el <unk> .
¿cuál es tu equipo de béisbol favorito ?	¿cuál es tu equipo de <unk> favorito ?
la policía espera que la gente siga la ley .	la policía encontró a <unk> a la policía .
los exámenes <unk> justo después de las vacaciones de verano .	los <unk> están bien después de verano .
¿está <unk> herido ?	¿estás <unk> <unk> ?
él puede con la tarea .	está a <unk> el <unk> .
tom <unk> una <unk> de nieve .	tom <unk> una <unk> de <unk> .
disculpe la <unk> .	estoy tarde .
no me vuelvas a llamar .	no me <unk> otra vez .
tom le dijo a mary que no fuera .	tom le dijo a mary que no vaya .
ella le hizo feliz .	ella lo hizo feliz .
te estábamos buscando .	estábamos buscando .
mary está <unk> .	mary es <unk> .
nos <unk> si <unk> cuándo <unk> la película .	ellos nos vimos a la película cuando nos encantan .
ese vestido se ve <unk> en ti .	parece que <unk> <unk> ese vestido .
roma no fue <unk> en un día .	no era un día en un día .
algunos hombres se <unk> las piernas .	algunos <unk> <unk> algunas <unk> .
tom es un amigo mío .	tom es un amigo de mío .
no sé por qué me <unk> en venir aquí .	no sé por qué me <unk> aquí .
sé que estás preocupada por tom .	sé que estás aquí con tom .
<unk> esto .	esto .
<unk> a todos en voz alta .	él <unk> todos los <unk> .
no tengo ganas de estudiar inglés hoy .	no me gusta estudiar inglés hoy .
ya te encontré .	encontré .
esta foto no es suya . es nuestra .	esta no es la <unk> de <unk> .
hemos estado ahí antes .	hemos estado allí .
no podemos dejar que nos <unk> .	no podemos ser <unk> .
el <unk> le disparó a un <unk> .	un <unk> <unk> <unk> un <unk> .
tom nunca dijo una palabra .	tom nunca dijo una palabra .
los <unk> se <unk> para <unk> el problema .	el problema se <unk> al problema .
el escritorio está cubierto de polvo .	el escritorio está cubierta con el escritorio .
juego con él .	lo hice con él .
<unk> para los niños , este libro a menudo lo <unk> <unk> .	este libro es un libro , por los <unk> de <unk> un libro que los <unk> .
todavía no ha <unk> la <unk> .	el <unk> no ha <unk> el <unk> .
el autobús <unk> .	el autobús se <unk> a tiempo .
me estoy <unk> a este clima .	estoy acostumbrado a tener que se <unk> este clima .
tom dejó claro que quería que mary hiciera el trabajo ella sola .	tom quería que mary lo <unk> a hacer eso .
él <unk> a su hijo a estudiar más .	él se <unk> a su hijo a <unk> .
por favor , <unk> <unk> .	por favor , <unk> <unk> .
¿acaso no sabes eso ?	¿no sabes eso ?
yo no <unk> a tom .	no voy a tom .
no soy esa clase de tipo .	no estoy tipo de ese tipo .
se <unk> .	eso es <unk> .
esta costumbre comenzó durante el <unk> <unk> .	esta <unk> <unk> <unk> <unk> <unk> al final .
no sé que podemos hacer .	no sé lo que podemos hacer .
voy a la escuela <unk> en bicicleta .	me <unk> el colegio .
mucho de lo que <unk> había oído acerca del <unk> <unk> era cierto .	muchos <unk> <unk> <unk> <unk> muchos <unk> de <unk> <unk> <unk> <unk> de la <unk> .
tres de mis hijos murieron .	mis hijos de tres hijos .
¿estás diciendo que soy un mentiroso ?	<unk> que te <unk> una <unk> ?
falta el punto al final de la <unk> .	el <unk> de <unk> , el final de <unk> es la <unk> .
déjame arreglarlo .	me <unk> .
solo necesito saber quién es tom .	solo necesito saber quién es tom .
los <unk> <unk> un juramento de no <unk> a nadie .	nadie le ha <unk> una mujer a nadie .
tom es <unk> .	tom es <unk> .
su respuesta fue <unk> .	su <unk> fue <unk> .
el juego se <unk> por la lluvia .	la lluvia <unk> fue al partido .
él <unk> dentro de un mes .	él <unk> un mes .
ellos se ven felices .	los niños se parece feliz .
quiero <unk> a tom .	quiero que tom nos ayude .
ella tiene que <unk> a su familia acerca de su novio .	ella tiene que <unk> a su familia .
te <unk> un <unk> .	te <unk> .
charla con tus amigos .	<unk> amigos con tus amigos .
el chico que está parado por allá es mi hijo .	mi hijo se está prohibido <unk> .
tu perro todavía me está <unk> .	tu perro me está todavía en el perro .
tom se <unk> de <unk> .	tom <unk> como <unk> .
me gustaría que <unk> a tom ir con nosotros .	ojalá <unk> que nos <unk> con tom .
tom y mary estaban hablando en francés cuando john entró a la habitación .	tom y mary estaban a john cuando maría en el cuarto .
amaba boston .	solía boston de boston .
no debes hablar mal a <unk> de los demás .	no tienes que sus <unk> de los demás <unk> <unk> <unk> .
¿adónde vas a ir en tus vacaciones ?	¿dónde te va a ir a tu pasaporte ?
él lloró y lloró .	él se sintió obligado a pie y <unk> .
ni siquiera sé qué es eso .	ni siquiera sé lo que es .
siempre está ocupado .	él siempre está ocupada .
no sé por qué me <unk> a mí .	no sé por qué me <unk> .
parece que no hay ninguna necesidad de ir .	no necesitas estar ahí para ir allí .
tom y mary son los dos <unk> .	tom y mary son los dos <unk> .
¿no querés darme un <unk> ?	¿no quieres una <unk> ?
él <unk> el <unk> de <unk> .	<unk> una <unk> <unk> <unk> <unk> <unk> <unk> <unk> .
puede que tenga que ayudar a tom .	puedo ayudar a tom .
si yo fuera tú , no habría hecho eso .	no he hecho eso si tienes .
